r8
c8
WWWWWWWW
W P    W
WWG  B W
WWW    W
W    W W
W      W
W    WWW
WWWWWWWW
