r8
c8
WWWWWWWW
W      W
WG  W  W
W  PWW W
W B    W
W      W
W    W W
WWWWWWWW
