r10
c10
   WWWWWWW
  WW  W PW
  W  QW  W
  WB B B W
  W BWW  W
WWW B W WW
W       W 
WGGGGG  W 
W       W 
WWWWWWWWW 