r9
c9
 WWWWWWW 
 W PGGGW 
 W   WWWW
WWWB    W
W   WBW W
W   W   W
W B WWWWW
W Q W    
WWWWW    