r8
c8
WWWWWWWW
W      W
WW     W
WWW    W
W  G   W
W  B P W
W      W
WWWWWWWW
