r8
c8
WWWWWWWW
W P    W
W   W  W
W W WW W
W      W
WGB    W
W      W
WWWWWWWW
