r8
c8
WWWWWWWW
WG     W
W P  B W
W      W
W      W
W      W
W    W W
WWWWWWWW
