r8
c8
WWWWWWWW
W W    W
W    W W
WPWW   W
W      W
W  B W W
WG     W
WWWWWWWW
