r8
c8
WWWWWWWW
W      W
WW B W W
WWW    W
W G    W
W  PW  W
W   WW W
WWWWWWWW
