r9
c9
  WWWW   
WWW  WW  
W GG  WWW
W       W
W BGB   W
W       W
WPB G B W
W  WW   W
WWWWWWWWW