r8
c8
WWWWWWWW
W W    W
W G P  W
W WW   W
W    B W
W   W  W
W   WW W
WWWWWWWW
