r8
c8
   WWWW 
 WWW PW 
 W  B W 
WW W WWW
W  W WGW
W W  BGW
W B   GW
WWWWWWWW 