r8
c8
WWWWWWWW
W   W  W
W W  BGW
WG  B  W
W W  BGW
W   W  W
WWWWWP W
    WWWW