r8
c8
   WWWW 
 WWW PW 
 W  B W 
WW W WWW
W  W WGW
W    BGW
W B Q GW
WWWWWWWW 